111111111111111111
1000001100010000C1
100000000110000001
1P00110E0000001001
111111111111111111
