1111111111111111111111111111111111
100000000000000C00000C0000E0000001
1010010100100000101001000000000101
1010010010101010001001000000010101
1P0000000C00C000000000000000000001
1000000010101000001000000000000001
1000000000000000001001000000000101
1000000000100000000010000000010101
1111111111111111111111111111111111