11111111111111111111111111111111111
100000000000000C00000C0000E00000011
10100101001000001010010000000001011
10100100101010100010010000000101011
1P0000000C00C0000000000000000000011
10000000101010000010000000000000011
10000000000000000010010000000001011
10000000001000000000100000100101011
11111111111111111111111111111111111
11111111111111111111111111111111111